The goal of this mod is to make ranged weapons more satisfying to use! This mod affects guns, magic guns, and launchers with 45 all new sounds! Add more punch to combat today!

Minishark 	> 	Machinegun (Quake 3)
Flint Pistol 	> 	Kar98 + Gangplank Q (Wolfenstein 2009 + LoL)
Boomstick 	> 	Sawed off Shotgun (Deep Rock Galactic)
Revolver 	> 	.357 Magnum (Fallout New Vegas)
Red Ryder	>	Lever Action Rifle (Killing Floor)
Musket 		> 	Kar98 + Gangplank Q (Wolfenstein 2009 + LoL)
Quad Barrel	>	Shotgun (Quake 4)
Handgun		>	9mm Pistol (Killing Floor)
Pew-matic Horn	>	Grenade Launcher (Quake 2)
Phoenix Blaster >	Subata 120 (Deep Rock Galactic)
Snowball Cannon >	Grenade Launcher (Team Fortress 2)
Sandgun		>	Grenade Launcher (Serious Sam)
Clockwork AR	>	Battle Rifle (Halo 3 (I had to))
Gatligator	>	Warthog Turret (Halo CE)
Shotgun		>	Shotgun (Left 4 Dead)
Onyx Blaster	>	Scatterblaster + Shotgun (Metal Arms + L4D)
Uzi		>	SMG (Half Life 2)
Megashark 	> 	Machinegun (Quake 3)
Venus Magnum	>	MK23 (Killing Floor)
Tactical Shotgun>	Spas-12 (Black Mesa)
Sniper Rifle 	>	Hunting Rifle + AWP (Fallout: NV + CSGO)
CandyCorn Rifle >	Nailgun (Quake)
Chain Gun	>	Chaingun (Quake 3)
Xeno Popper	>	Bio Rifle (Unreal Tournament 3)
S.D.M.G.	>	SPEW (Metal Arms)
Grenade Launcher>	M79 (Killing FLoor)
Proxy Launcher	>	M319 (Halo Reach)
Rocket Launcher >	Rocket Launcher (Metal Arms)
Nailgun		>	Multichamber Zed Thrower (Killing Floor)
Pumpkin Launcher>	Gunner Grenade Launcher + Reload (Quake 2)
Snowman Cannon 	>	Homing Launcher (Timesplitters 2)
Stynger		>	Loch and Load (Team Fortress 2)
Electrosphere 	>	Pomson 6000 crit (Team Fortress 2)
Celebrations	>	Detonator (Team Fortress 2)
Dart Guns	> 	Flare Gun (Deep Rock Galactic)
Coin Gun 	>	Machinegun (Doom 3)
Space Gun	>	Plasma Pistol (Halo: CE)
Bee Gun		>	Needler + Vespid VO (Halo 2 + Dawn of War)
LaserRifle	>	Mining Laser (Metal Arms)
Wasp Gun	>	Needler + Vespid VO (Halo 2 + Dawn of War)
Leaf Blower	>	TMP (Counter Strike Source)
Heat Ray	>	Laser Rifle (Fallout 3)

Thoughts, feedback and bug reports are appreciated